date,Lane 1 Flow (Veh/5 Minutes),Lane 2 Flow (Veh/5 Minutes),Lane 3 Flow (Veh/5 Minutes),Lane 4 Flow (Veh/5 Minutes),Flow (Veh/5 Minutes),# Lane Points,% Observed
2018-06-04 00:00:00,20,26,29,26,101,4,100
2018-06-04 00:05:00,26,21,32,20,99,4,100
2018-06-04 00:10:00,13,23,24,21,81,4,100
2018-06-04 00:15:00,20,39,31,24,114,4,100
2018-06-04 00:20:00,9,18,27,23,77,4,100
2018-06-04 00:25:00,10,27,27,24,88,4,100
2018-06-04 00:30:00,20,25,33,19,97,4,100
2018-06-04 00:35:00,19,19,28,20,86,4,100
2018-06-04 00:40:00,12,22,21,14,69,4,100
2018-06-04 00:45:00,12,18,15,18,63,4,100
2018-06-04 00:50:00,9,17,17,20,63,4,100
2018-06-04 00:55:00,8,14,23,12,57,4,100
2018-06-04 01:00:00,6,17,27,22,72,4,100
2018-06-04 01:05:00,4,17,21,14,56,4,100
2018-06-04 01:10:00,4,15,16,18,53,4,100
2018-06-04 01:15:00,5,12,22,19,58,4,100
2018-06-04 01:20:00,11,16,19,15,61,4,100
2018-06-04 01:25:00,10,14,14,17,55,4,100
2018-06-04 01:30:00,8,13,19,14,54,4,100
2018-06-04 01:35:00,2,14,11,17,44,4,100
2018-06-04 01:40:00,7,16,15,10,48,4,100
2018-06-04 01:45:00,13,20,16,14,63,4,100
2018-06-04 01:50:00,11,14,20,18,63,4,100
2018-06-04 01:55:00,7,17,18,12,54,4,100
2018-06-04 02:00:00,1,9,14,12,36,4,100
2018-06-04 02:05:00,5,13,17,7,42,4,100
2018-06-04 02:10:00,3,10,12,14,39,4,100
2018-06-04 02:15:00,5,14,14,7,40,4,100
2018-06-04 02:20:00,5,10,9,8,32,4,100
2018-06-04 02:25:00,1,12,13,18,44,4,100
2018-06-04 02:30:00,6,12,13,17,48,4,100
2018-06-04 02:35:00,8,14,9,11,42,4,100
2018-06-04 02:40:00,4,9,9,11,33,4,100
2018-06-04 02:45:00,7,12,12,17,48,4,100
2018-06-04 02:50:00,9,13,14,22,58,4,100
2018-06-04 02:55:00,4,13,10,17,44,4,100
2018-06-04 03:00:00,5,19,14,17,55,4,100
2018-06-04 03:05:00,3,10,15,16,44,4,100
2018-06-04 03:10:00,6,14,19,20,59,4,100
2018-06-04 03:15:00,6,9,12,18,45,4,100
2018-06-04 03:20:00,8,13,23,15,59,4,100
2018-06-04 03:25:00,8,16,19,23,66,4,100
2018-06-04 03:30:00,6,20,20,26,72,4,100
2018-06-04 03:35:00,11,35,31,33,110,4,100
2018-06-04 03:40:00,13,29,34,21,97,4,100
2018-06-04 03:45:00,14,30,34,35,113,4,100
2018-06-04 03:50:00,15,38,35,27,115,4,100
2018-06-04 03:55:00,3,25,24,30,82,4,100
2018-06-04 04:00:00,16,18,23,23,80,4,100
2018-06-04 04:05:00,13,18,18,21,70,4,100
2018-06-04 04:10:00,10,34,29,20,93,4,100
2018-06-04 04:15:00,8,25,24,26,83,4,100
2018-06-04 04:20:00,13,27,31,29,100,4,100
2018-06-04 04:25:00,15,28,36,30,109,4,100
2018-06-04 04:30:00,16,29,44,29,118,4,100
2018-06-04 04:35:00,25,36,44,45,150,4,100
2018-06-04 04:40:00,33,49,57,42,181,4,100
2018-06-04 04:45:00,36,55,52,55,198,4,100
2018-06-04 04:50:00,43,56,61,40,200,4,100
2018-06-04 04:55:00,29,55,40,36,160,4,100
2018-06-04 05:00:00,31,31,37,38,137,4,100
2018-06-04 05:05:00,23,39,46,29,137,4,100
2018-06-04 05:10:00,33,51,48,35,167,4,100
2018-06-04 05:15:00,28,48,42,43,161,4,100
2018-06-04 05:20:00,42,58,53,47,200,4,100
2018-06-04 05:25:00,55,60,63,48,226,4,100
2018-06-04 05:30:00,45,62,60,63,230,4,100
2018-06-04 05:35:00,55,66,72,64,257,4,100
2018-06-04 05:40:00,81,79,82,88,330,4,100
2018-06-04 05:45:00,90,99,91,87,367,4,100
2018-06-04 05:50:00,88,100,95,79,362,4,100
2018-06-04 05:55:00,63,87,76,71,297,4,100
2018-06-04 06:00:00,59,75,66,54,254,4,100
2018-06-04 06:05:00,44,63,67,57,231,4,100
2018-06-04 06:10:00,68,80,66,62,276,4,100
2018-06-04 06:15:00,72,88,77,70,307,4,100
2018-06-04 06:20:00,79,79,84,78,320,4,100
2018-06-04 06:25:00,79,90,82,82,333,4,100
2018-06-04 06:30:00,80,91,94,75,340,4,100
2018-06-04 06:35:00,94,100,84,106,384,4,100
2018-06-04 06:40:00,107,107,111,108,433,4,100
2018-06-04 06:45:00,114,110,103,108,435,4,100
2018-06-04 06:50:00,127,125,102,111,465,4,100
2018-06-04 06:55:00,116,111,91,109,427,4,100
2018-06-04 07:00:00,98,103,104,95,400,4,100
2018-06-04 07:05:00,114,118,111,107,450,4,100
2018-06-04 07:10:00,129,119,122,132,502,4,100
2018-06-04 07:15:00,125,124,124,124,497,4,100
2018-06-04 07:20:00,121,111,111,125,468,4,100
2018-06-04 07:25:00,118,121,107,101,447,4,100
2018-06-04 07:30:00,109,111,116,107,443,4,100
2018-06-04 07:35:00,162,126,106,114,508,4,100
2018-06-04 07:40:00,143,139,119,107,508,4,100
2018-06-04 07:45:00,160,142,136,122,560,4,100
2018-06-04 07:50:00,141,131,131,110,513,4,100
2018-06-04 07:55:00,142,113,112,107,474,4,100
2018-06-04 08:00:00,119,118,112,111,460,4,100
2018-06-04 08:05:00,120,107,104,89,420,4,100
2018-06-04 08:10:00,132,123,114,110,479,4,100
2018-06-04 08:15:00,104,115,103,108,430,4,100
2018-06-04 08:20:00,115,106,108,92,421,4,100
2018-06-04 08:25:00,97,116,97,96,406,4,100
2018-06-04 08:30:00,101,104,105,95,405,4,100
2018-06-04 08:35:00,102,101,109,90,402,4,100
2018-06-04 08:40:00,87,101,86,95,369,4,100
2018-06-04 08:45:00,94,110,96,95,395,4,100
2018-06-04 08:50:00,92,110,99,101,402,4,100
2018-06-04 08:55:00,106,116,105,83,410,4,100
2018-06-04 09:00:00,103,99,102,89,393,4,100
2018-06-04 09:05:00,87,113,91,90,381,4,100
2018-06-04 09:10:00,104,93,100,82,379,4,100
2018-06-04 09:15:00,71,102,103,91,367,4,100
2018-06-04 09:20:00,103,95,110,100,408,4,100
2018-06-04 09:25:00,92,111,105,100,408,4,100
2018-06-04 09:30:00,101,94,104,87,386,4,100
2018-06-04 09:35:00,101,103,118,91,413,4,100
2018-06-04 09:40:00,84,108,113,99,404,4,100
2018-06-04 09:45:00,107,113,112,122,454,4,100
2018-06-04 09:50:00,78,109,101,94,382,4,100
2018-06-04 09:55:00,91,100,104,109,404,4,100
2018-06-04 10:00:00,102,103,94,105,404,4,100
2018-06-04 10:05:00,70,94,94,74,332,4,100
2018-06-04 10:10:00,85,101,89,101,376,4,100
2018-06-04 10:15:00,92,109,100,106,407,4,100
2018-06-04 10:20:00,81,105,107,98,391,4,100
2018-06-04 10:25:00,81,100,89,81,351,4,100
2018-06-04 10:30:00,90,108,102,98,398,4,100
2018-06-04 10:35:00,88,108,93,103,392,4,100
2018-06-04 10:40:00,99,100,108,109,416,4,100
2018-06-04 10:45:00,97,111,111,104,423,4,100
2018-06-04 10:50:00,112,121,115,94,442,4,100
2018-06-04 10:55:00,85,100,110,92,387,4,100
2018-06-04 11:00:00,91,114,99,95,399,4,100
2018-06-04 11:05:00,105,125,106,91,427,4,100
2018-06-04 11:10:00,93,117,101,91,402,4,100
2018-06-04 11:15:00,89,103,87,79,358,4,100
2018-06-04 11:20:00,123,138,103,91,455,4,100
2018-06-04 11:25:00,89,106,123,88,406,4,100
2018-06-04 11:30:00,82,96,104,87,369,4,100
2018-06-04 11:35:00,98,104,113,87,402,4,100
2018-06-04 11:40:00,105,121,110,96,432,4,100
2018-06-04 11:45:00,126,103,109,100,438,4,100
2018-06-04 11:50:00,114,126,122,102,464,4,100
2018-06-04 11:55:00,101,120,114,82,417,4,100
2018-06-04 12:00:00,89,109,103,98,399,4,100
2018-06-04 12:05:00,103,120,97,95,415,4,100
2018-06-04 12:10:00,91,101,107,92,391,4,100
2018-06-04 12:15:00,112,113,114,84,423,4,100
2018-06-04 12:20:00,98,110,111,98,417,4,100
2018-06-04 12:25:00,133,139,118,96,486,4,100
2018-06-04 12:30:00,141,129,126,110,506,4,100
2018-06-04 12:35:00,102,107,116,98,423,4,100
2018-06-04 12:40:00,107,126,114,106,453,4,100
2018-06-04 12:45:00,122,140,105,107,474,4,100
2018-06-04 12:50:00,124,133,112,108,477,4,100
2018-06-04 12:55:00,113,125,102,98,438,4,100
2018-06-04 13:00:00,128,124,108,91,451,4,100
2018-06-04 13:05:00,109,133,107,103,452,4,100
2018-06-04 13:10:00,116,132,99,100,447,4,100
2018-06-04 13:15:00,134,118,132,82,466,4,100
2018-06-04 13:20:00,118,127,104,96,445,4,100
2018-06-04 13:25:00,104,129,110,108,451,4,100
2018-06-04 13:30:00,102,123,113,97,435,4,100
2018-06-04 13:35:00,138,137,117,107,499,4,100
2018-06-04 13:40:00,116,129,118,101,464,4,100
2018-06-04 13:45:00,138,141,109,117,505,4,100
2018-06-04 13:50:00,119,127,130,103,479,4,100
2018-06-04 13:55:00,138,132,111,107,488,4,100
2018-06-04 14:00:00,162,131,111,100,504,4,100
2018-06-04 14:05:00,147,137,124,100,508,4,100
2018-06-04 14:10:00,125,129,119,101,474,4,100
2018-06-04 14:15:00,141,144,115,92,492,4,100
2018-06-04 14:20:00,142,132,122,102,498,4,100
2018-06-04 14:25:00,132,124,108,107,471,4,100
2018-06-04 14:30:00,143,148,128,118,537,4,100
2018-06-04 14:35:00,147,126,122,109,504,4,100
2018-06-04 14:40:00,164,142,133,121,560,4,100
2018-06-04 14:45:00,157,151,122,115,545,4,100
2018-06-04 14:50:00,158,137,138,131,564,4,100
2018-06-04 14:55:00,155,146,135,111,547,4,100
2018-06-04 15:00:00,149,134,126,119,528,4,100
2018-06-04 15:05:00,149,119,133,104,505,4,100
2018-06-04 15:10:00,145,128,124,100,497,4,100
2018-06-04 15:15:00,162,162,149,119,592,4,100
2018-06-04 15:20:00,134,117,124,106,481,4,100
2018-06-04 15:25:00,145,136,142,116,539,4,100
2018-06-04 15:30:00,139,132,122,119,512,4,100
2018-06-04 15:35:00,144,128,118,120,510,4,100
2018-06-04 15:40:00,149,142,127,109,527,4,100
2018-06-04 15:45:00,154,147,122,120,543,4,100
2018-06-04 15:50:00,158,143,121,120,542,4,100
2018-06-04 15:55:00,149,148,128,116,541,4,100
2018-06-04 16:00:00,153,150,131,106,540,4,100
2018-06-04 16:05:00,119,130,123,110,482,4,100
2018-06-04 16:10:00,132,127,136,108,503,4,100
2018-06-04 16:15:00,145,137,136,114,532,4,100
2018-06-04 16:20:00,128,134,117,103,482,4,100
2018-06-04 16:25:00,140,137,128,110,515,4,100
2018-06-04 16:30:00,122,114,121,87,444,4,100
2018-06-04 16:35:00,149,135,136,111,531,4,100
2018-06-04 16:40:00,141,131,125,115,512,4,100
2018-06-04 16:45:00,123,120,136,117,496,4,100
2018-06-04 16:50:00,127,117,126,100,470,4,100
2018-06-04 16:55:00,141,145,126,113,525,4,100
2018-06-04 17:00:00,129,118,128,101,476,4,100
2018-06-04 17:05:00,143,141,138,109,531,4,100
2018-06-04 17:10:00,129,126,115,89,459,4,100
2018-06-04 17:15:00,116,115,103,67,401,4,100
2018-06-04 17:20:00,145,138,118,83,484,4,100
2018-06-04 17:25:00,144,139,130,114,527,4,100
2018-06-04 17:30:00,163,158,136,110,567,4,100
2018-06-04 17:35:00,155,133,140,101,529,4,100
2018-06-04 17:40:00,170,144,135,111,560,4,100
2018-06-04 17:45:00,156,148,123,117,544,4,100
2018-06-04 17:50:00,155,156,135,109,555,4,100
2018-06-04 17:55:00,152,147,125,104,528,4,100
2018-06-04 18:00:00,144,131,131,114,520,4,100
2018-06-04 18:05:00,149,148,131,108,536,4,100
2018-06-04 18:10:00,144,137,122,99,502,4,100
2018-06-04 18:15:00,160,129,109,89,487,4,100
2018-06-04 18:20:00,127,136,125,95,483,4,100
2018-06-04 18:25:00,127,125,109,97,458,4,100
2018-06-04 18:30:00,116,121,116,98,451,4,100
2018-06-04 18:35:00,122,107,93,74,396,4,100
2018-06-04 18:40:00,135,125,104,80,444,4,100
2018-06-04 18:45:00,113,110,86,75,384,4,100
2018-06-04 18:50:00,127,127,105,98,457,4,100
2018-06-04 18:55:00,110,123,102,80,415,4,100
2018-06-04 19:00:00,88,96,100,82,366,4,100
2018-06-04 19:05:00,103,108,101,73,385,4,100
2018-06-04 19:10:00,97,103,102,81,383,4,100
2018-06-04 19:15:00,100,108,96,82,386,4,100
2018-06-04 19:20:00,118,110,95,70,393,4,100
2018-06-04 19:25:00,98,112,96,71,377,4,100
2018-06-04 19:30:00,80,107,85,79,351,4,100
2018-06-04 19:35:00,98,94,97,79,368,4,100
2018-06-04 19:40:00,90,100,91,70,351,4,100
2018-06-04 19:45:00,98,86,76,67,327,4,100
2018-06-04 19:50:00,107,115,99,76,397,4,100
2018-06-04 19:55:00,84,88,85,68,325,4,100
2018-06-04 20:00:00,99,85,81,62,327,4,100
2018-06-04 20:05:00,97,95,88,61,341,4,100
2018-06-04 20:10:00,79,94,100,67,340,4,100
2018-06-04 20:15:00,87,101,82,62,332,4,100
2018-06-04 20:20:00,78,92,74,66,310,4,100
2018-06-04 20:25:00,81,84,75,59,299,4,100
2018-06-04 20:30:00,90,90,74,69,323,4,100
2018-06-04 20:35:00,91,87,88,67,333,4,100
2018-06-04 20:40:00,61,85,81,58,285,4,100
2018-06-04 20:45:00,73,73,70,54,270,4,100
2018-06-04 20:50:00,82,82,82,58,304,4,100
2018-06-04 20:55:00,80,81,73,62,296,4,100
2018-06-04 21:00:00,73,76,64,64,277,4,100
2018-06-04 21:05:00,74,71,70,53,268,4,100
2018-06-04 21:10:00,69,82,75,53,279,4,100
2018-06-04 21:15:00,65,67,75,65,272,4,100
2018-06-04 21:20:00,58,75,77,64,274,4,100
2018-06-04 21:25:00,55,64,84,52,255,4,100
2018-06-04 21:30:00,62,80,72,48,262,4,100
2018-06-04 21:35:00,55,61,58,45,219,4,100
2018-06-04 21:40:00,48,68,54,44,214,4,100
2018-06-04 21:45:00,74,66,54,47,241,4,100
2018-06-04 21:50:00,60,72,65,46,243,4,100
2018-06-04 21:55:00,51,59,59,44,213,4,100
2018-06-04 22:00:00,48,57,82,57,244,4,100
2018-06-04 22:05:00,55,69,65,47,236,4,100
2018-06-04 22:10:00,51,60,51,51,213,4,100
2018-06-04 22:15:00,49,64,57,39,209,4,100
2018-06-04 22:20:00,60,64,63,50,237,4,100
2018-06-04 22:25:00,45,54,51,45,195,4,100
2018-06-04 22:30:00,52,63,51,45,211,4,100
2018-06-04 22:35:00,40,61,56,41,198,4,100
2018-06-04 22:40:00,46,65,62,36,209,4,100
2018-06-04 22:45:00,38,65,49,39,191,4,100
2018-06-04 22:50:00,41,59,56,45,201,4,100
2018-06-04 22:55:00,53,53,53,40,199,4,100
2018-06-04 23:00:00,34,45,45,41,165,4,100
2018-06-04 23:05:00,32,47,38,28,145,4,100
2018-06-04 23:10:00,32,54,41,33,160,4,100
2018-06-04 23:15:00,22,38,34,32,126,4,100
2018-06-04 23:20:00,26,32,51,32,141,4,100
2018-06-04 23:25:00,28,45,40,38,151,4,100
2018-06-04 23:30:00,28,37,41,32,138,4,100
2018-06-04 23:35:00,25,33,41,37,136,4,100
2018-06-04 23:40:00,36,42,35,30,143,4,100
2018-06-04 23:45:00,31,37,43,32,143,4,100
2018-06-04 23:50:00,30,36,40,32,138,4,100
2018-06-04 23:55:00,26,37,40,33,136,4,100
2018-06-05 00:00:00,27,41,28,28,124,4,100
2018-06-05 00:05:00,37,42,31,30,140,4,100
2018-06-05 00:10:00,26,29,29,17,101,4,100
2018-06-05 00:15:00,20,32,28,15,95,4,100
2018-06-05 00:20:00,28,36,27,31,122,4,100
2018-06-05 00:25:00,20,29,26,23,98,4,100
2018-06-05 00:30:00,14,21,20,18,73,4,100
2018-06-05 00:35:00,10,26,20,23,79,4,100
2018-06-05 00:40:00,17,25,16,19,77,4,100
2018-06-05 00:45:00,16,25,22,17,80,4,100
2018-06-05 00:50:00,17,16,23,24,80,4,100
2018-06-05 00:55:00,9,20,24,19,72,4,100
2018-06-05 01:00:00,11,26,17,22,76,4,100
2018-06-05 01:05:00,10,12,21,22,65,4,100
2018-06-05 01:10:00,9,18,26,23,76,4,100
2018-06-05 01:15:00,14,23,18,18,73,4,100
2018-06-05 01:20:00,8,18,21,19,66,4,100
2018-06-05 01:25:00,13,17,23,29,82,4,100
2018-06-05 01:30:00,6,22,13,23,64,4,100
2018-06-05 01:35:00,5,11,23,19,58,4,100
2018-06-05 01:40:00,9,22,18,27,76,4,100
2018-06-05 01:45:00,10,14,17,24,65,4,100
2018-06-05 01:50:00,7,15,15,22,59,4,100
2018-06-05 01:55:00,7,17,20,23,67,4,100
2018-06-05 02:00:00,5,18,20,17,60,4,100
2018-06-05 02:05:00,5,13,21,16,55,4,100
2018-06-05 02:10:00,9,11,14,15,49,4,100
2018-06-05 02:15:00,13,16,15,16,60,4,100
2018-06-05 02:20:00,10,17,22,20,69,4,100
2018-06-05 02:25:00,5,11,19,21,56,4,100
2018-06-05 02:30:00,7,18,18,22,65,4,100
2018-06-05 02:35:00,8,17,23,29,77,4,100
2018-06-05 02:40:00,6,16,19,18,59,4,100
2018-06-05 02:45:00,8,20,29,30,87,4,100
2018-06-05 02:50:00,6,13,16,23,58,4,100
2018-06-05 02:55:00,3,20,14,18,55,4,100
2018-06-05 03:00:00,7,14,17,19,57,4,100
2018-06-05 03:05:00,6,14,19,17,56,4,100
2018-06-05 03:10:00,5,11,14,18,48,4,100
2018-06-05 03:15:00,11,16,19,22,68,4,100
2018-06-05 03:20:00,6,17,22,16,61,4,100
2018-06-05 03:25:00,7,26,23,21,77,4,100
2018-06-05 03:30:00,5,18,22,27,72,4,100
2018-06-05 03:35:00,16,24,21,20,81,4,100
2018-06-05 03:40:00,16,24,33,32,105,4,100
2018-06-05 03:45:00,18,28,33,30,109,4,100
2018-06-05 03:50:00,22,30,32,25,109,4,100
2018-06-05 03:55:00,13,24,33,26,96,4,100
2018-06-05 04:00:00,12,19,21,26,78,4,100
2018-06-05 04:05:00,12,23,29,24,88,4,100
2018-06-05 04:10:00,10,30,25,25,90,4,100
2018-06-05 04:15:00,18,28,29,19,94,4,100
2018-06-05 04:20:00,15,37,38,37,127,4,100
2018-06-05 04:25:00,17,35,34,41,127,4,100
2018-06-05 04:30:00,18,27,36,33,114,4,100
2018-06-05 04:35:00,29,44,50,42,165,4,100
2018-06-05 04:40:00,25,46,44,34,149,4,100
2018-06-05 04:45:00,37,66,59,50,212,4,100
2018-06-05 04:50:00,31,59,55,46,191,4,100
2018-06-05 04:55:00,20,41,39,37,137,4,100
2018-06-05 05:00:00,18,33,45,46,142,4,100
2018-06-05 05:05:00,24,33,36,32,125,4,100
2018-06-05 05:10:00,27,35,43,31,136,4,100
2018-06-05 05:15:00,28,42,45,46,161,4,100
2018-06-05 05:20:00,34,46,51,46,177,4,100
2018-06-05 05:25:00,34,48,48,56,186,4,100
2018-06-05 05:30:00,43,63,61,69,236,4,100
2018-06-05 05:35:00,43,66,60,59,228,4,100
2018-06-05 05:40:00,60,83,82,81,306,4,100
2018-06-05 05:45:00,80,98,84,76,338,4,100
2018-06-05 05:50:00,78,88,80,79,325,4,100
2018-06-05 05:55:00,44,77,73,69,263,4,100
2018-06-05 06:00:00,48,71,60,70,249,4,100
2018-06-05 06:05:00,29,56,66,55,206,4,100
2018-06-05 06:10:00,61,77,72,64,274,4,100
2018-06-05 06:15:00,63,84,73,80,300,4,100
2018-06-05 06:20:00,78,93,83,73,327,4,100
2018-06-05 06:25:00,80,79,83,71,313,4,100
2018-06-05 06:30:00,90,98,98,86,372,4,100
2018-06-05 06:35:00,81,92,91,93,357,4,100
2018-06-05 06:40:00,105,109,108,94,416,4,100
2018-06-05 06:45:00,134,126,114,125,499,4,100
2018-06-05 06:50:00,145,115,117,125,502,4,100
2018-06-05 06:55:00,136,116,106,117,475,4,100
2018-06-05 07:00:00,92,112,116,105,425,4,100
2018-06-05 07:05:00,106,103,118,103,430,4,100
2018-06-05 07:10:00,112,105,107,118,442,4,100
2018-06-05 07:15:00,135,122,113,129,499,4,100
2018-06-05 07:20:00,128,117,141,137,523,4,100
2018-06-05 07:25:00,128,114,126,114,482,4,100
2018-06-05 07:30:00,132,109,107,117,465,4,100
2018-06-05 07:35:00,115,101,86,97,399,4,100
2018-06-05 07:40:00,122,122,112,99,455,4,100
2018-06-05 07:45:00,152,130,116,107,505,4,100
2018-06-05 07:50:00,153,135,131,139,558,4,100
2018-06-05 07:55:00,149,149,123,124,545,4,100
2018-06-05 08:00:00,130,131,110,118,489,4,100
2018-06-05 08:05:00,128,123,106,88,445,4,100
2018-06-05 08:10:00,125,125,94,109,453,4,100
2018-06-05 08:15:00,119,114,101,101,435,4,100
2018-06-05 08:20:00,117,110,97,93,417,4,100
2018-06-05 08:25:00,70,106,97,79,352,4,100
2018-06-05 08:30:00,97,119,92,94,402,4,100
2018-06-05 08:35:00,113,107,97,99,416,4,100
2018-06-05 08:40:00,113,134,119,112,478,4,100
2018-06-05 08:45:00,93,106,109,98,406,4,100
2018-06-05 08:50:00,115,103,106,105,429,4,100
2018-06-05 08:55:00,96,108,95,85,384,4,100
2018-06-05 09:00:00,96,101,113,89,399,4,100
2018-06-05 09:05:00,59,83,90,90,322,4,100
2018-06-05 09:10:00,63,78,93,93,327,4,100
2018-06-05 09:15:00,91,86,107,85,369,4,100
2018-06-05 09:20:00,134,124,99,107,464,4,100
2018-06-05 09:25:00,119,122,120,100,461,4,100
2018-06-05 09:30:00,107,121,109,107,444,4,100
2018-06-05 09:35:00,101,107,106,107,421,4,100
2018-06-05 09:40:00,93,107,104,107,411,4,100
2018-06-05 09:45:00,92,110,108,106,416,4,100
2018-06-05 09:50:00,101,103,106,115,425,4,100
2018-06-05 09:55:00,102,122,112,86,422,4,100
2018-06-05 10:00:00,126,132,126,116,500,4,100
2018-06-05 10:05:00,100,110,112,95,417,4,100
2018-06-05 10:10:00,125,129,118,104,476,4,100
2018-06-05 10:15:00,114,134,122,103,473,4,100
2018-06-05 10:20:00,127,129,119,100,475,4,100
2018-06-05 10:25:00,117,122,112,106,457,4,100
2018-06-05 10:30:00,113,125,116,119,473,4,100
2018-06-05 10:35:00,126,145,113,113,497,4,100
2018-06-05 10:40:00,106,114,100,97,417,4,100
2018-06-05 10:45:00,130,131,126,104,491,4,100
2018-06-05 10:50:00,104,126,119,113,462,4,100
2018-06-05 10:55:00,115,103,118,90,426,4,100
2018-06-05 11:00:00,99,127,106,85,417,4,100
2018-06-05 11:05:00,108,114,112,94,428,4,100
2018-06-05 11:10:00,142,133,116,110,501,4,100
2018-06-05 11:15:00,98,119,115,92,424,4,100
2018-06-05 11:20:00,125,129,115,118,487,4,100
2018-06-05 11:25:00,105,104,99,82,390,4,100
2018-06-05 11:30:00,112,131,96,101,440,4,100
2018-06-05 11:35:00,110,126,113,90,439,4,100
2018-06-05 11:40:00,116,116,109,94,435,4,100
2018-06-05 11:45:00,100,124,128,93,445,4,100
2018-06-05 11:50:00,114,123,103,95,435,4,100
2018-06-05 11:55:00,99,125,99,103,426,4,100
2018-06-05 12:00:00,91,123,90,83,387,4,100
2018-06-05 12:05:00,114,112,107,88,421,4,100
2018-06-05 12:10:00,114,115,118,96,443,4,100
2018-06-05 12:15:00,131,128,118,100,477,4,100
2018-06-05 12:20:00,109,130,95,96,430,4,100
2018-06-05 12:25:00,130,110,105,99,444,4,100
2018-06-05 12:30:00,106,120,120,108,454,4,100
2018-06-05 12:35:00,123,120,122,98,463,4,100
2018-06-05 12:40:00,117,121,112,98,448,4,100
2018-06-05 12:45:00,117,140,110,110,477,4,100
2018-06-05 12:50:00,128,132,107,100,467,4,100
2018-06-05 12:55:00,126,122,100,104,452,4,100
2018-06-05 13:00:00,120,115,118,109,462,4,100
2018-06-05 13:05:00,154,134,102,112,502,4,100
2018-06-05 13:10:00,146,129,127,110,512,4,100
2018-06-05 13:15:00,126,147,107,94,474,4,100
2018-06-05 13:20:00,135,131,116,101,483,4,100
2018-06-05 13:25:00,131,137,116,110,494,4,100
2018-06-05 13:30:00,129,122,98,97,446,4,100
2018-06-05 13:35:00,145,143,127,114,529,4,100
2018-06-05 13:40:00,131,146,134,108,519,4,100
2018-06-05 13:45:00,138,151,115,124,528,4,100
2018-06-05 13:50:00,135,128,128,101,492,4,100
2018-06-05 13:55:00,139,126,110,100,475,4,100
2018-06-05 14:00:00,129,123,129,99,480,4,100
2018-06-05 14:05:00,147,144,129,114,534,4,100
2018-06-05 14:10:00,137,139,110,90,476,4,100
2018-06-05 14:15:00,171,144,123,93,531,4,100
2018-06-05 14:20:00,140,134,109,112,495,4,100
2018-06-05 14:25:00,166,150,129,102,547,4,100
2018-06-05 14:30:00,166,151,129,108,554,4,100
2018-06-05 14:35:00,160,140,129,100,529,4,100
2018-06-05 14:40:00,155,143,133,116,547,4,100
2018-06-05 14:45:00,142,139,146,126,553,4,100
2018-06-05 14:50:00,154,137,121,120,532,4,100
2018-06-05 14:55:00,135,134,137,110,516,4,100
2018-06-05 15:00:00,146,134,133,107,520,4,100
2018-06-05 15:05:00,143,130,129,111,513,4,100
2018-06-05 15:10:00,146,138,140,112,536,4,100
2018-06-05 15:15:00,150,142,122,112,526,4,100
2018-06-05 15:20:00,161,146,135,115,557,4,100
2018-06-05 15:25:00,157,140,128,107,532,4,100
2018-06-05 15:30:00,169,154,138,102,563,4,100
2018-06-05 15:35:00,164,149,125,116,554,4,100
2018-06-05 15:40:00,168,153,141,114,576,4,100
2018-06-05 15:45:00,144,136,135,111,526,4,100
2018-06-05 15:50:00,136,132,135,109,512,4,100
2018-06-05 15:55:00,116,116,111,91,434,4,100
2018-06-05 16:00:00,112,115,107,90,424,4,100
2018-06-05 16:05:00,109,105,107,98,419,4,100
2018-06-05 16:10:00,97,106,99,71,373,4,100
2018-06-05 16:15:00,110,108,111,78,407,4,100
2018-06-05 16:20:00,111,104,110,90,415,4,100
2018-06-05 16:25:00,117,112,103,81,413,4,100
2018-06-05 16:30:00,117,104,99,90,410,4,100
2018-06-05 16:35:00,120,105,100,96,421,4,100
2018-06-05 16:40:00,114,118,118,89,439,4,100
2018-06-05 16:45:00,121,126,129,97,473,4,100
2018-06-05 16:50:00,131,127,122,102,482,4,100
2018-06-05 16:55:00,130,120,114,93,457,4,100
2018-06-05 17:00:00,129,128,139,114,510,4,100
2018-06-05 17:05:00,132,127,138,113,510,4,100
2018-06-05 17:10:00,130,118,128,96,472,4,100
2018-06-05 17:15:00,124,129,122,95,470,4,100
2018-06-05 17:20:00,126,118,113,75,432,4,100
2018-06-05 17:25:00,124,122,107,75,428,4,100
2018-06-05 17:30:00,149,133,115,92,489,4,100
2018-06-05 17:35:00,162,159,122,94,537,4,100
2018-06-05 17:40:00,140,137,120,108,505,4,100
2018-06-05 17:45:00,155,137,126,100,518,4,100
2018-06-05 17:50:00,123,130,113,89,455,4,100
2018-06-05 17:55:00,134,127,113,97,471,4,100
2018-06-05 18:00:00,141,132,111,80,464,4,100
2018-06-05 18:05:00,129,126,112,87,454,4,100
2018-06-05 18:10:00,147,125,133,106,511,4,100
2018-06-05 18:15:00,142,130,120,95,487,4,100
2018-06-05 18:20:00,119,118,112,90,439,4,100
2018-06-05 18:25:00,159,128,126,105,518,4,100
2018-06-05 18:30:00,136,123,123,89,471,4,100
2018-06-05 18:35:00,154,120,119,93,486,4,100
2018-06-05 18:40:00,153,131,126,83,493,4,100
2018-06-05 18:45:00,149,141,130,95,515,4,100
2018-06-05 18:50:00,147,118,93,81,439,4,100
2018-06-05 18:55:00,118,110,93,79,400,4,100
2018-06-05 19:00:00,145,144,120,91,500,4,100
2018-06-05 19:05:00,129,116,100,89,434,4,100
2018-06-05 19:10:00,129,121,101,78,429,4,100
2018-06-05 19:15:00,118,124,116,89,447,4,100
2018-06-05 19:20:00,123,113,91,70,397,4,100
2018-06-05 19:25:00,101,103,91,82,377,4,100
2018-06-05 19:30:00,88,118,95,71,372,4,100
2018-06-05 19:35:00,102,94,101,75,372,4,100
2018-06-05 19:40:00,96,108,97,79,380,4,100
2018-06-05 19:45:00,114,88,92,68,362,4,100
2018-06-05 19:50:00,110,114,85,74,383,4,100
2018-06-05 19:55:00,99,105,81,69,354,4,100
2018-06-05 20:00:00,79,100,78,75,332,4,100
2018-06-05 20:05:00,82,85,82,71,320,4,100
2018-06-05 20:10:00,95,96,95,69,355,4,100
2018-06-05 20:15:00,89,83,88,60,320,4,100
2018-06-05 20:20:00,105,102,88,77,372,4,100
2018-06-05 20:25:00,94,97,85,75,351,4,100
2018-06-05 20:30:00,82,84,75,58,299,4,100
2018-06-05 20:35:00,68,81,94,77,320,4,100
2018-06-05 20:40:00,90,88,79,65,322,4,100
2018-06-05 20:45:00,88,84,86,65,323,4,100
2018-06-05 20:50:00,81,96,82,71,330,4,100
2018-06-05 20:55:00,76,71,74,56,277,4,100
2018-06-05 21:00:00,77,89,85,73,324,4,100
2018-06-05 21:05:00,84,94,91,69,338,4,100
2018-06-05 21:10:00,73,81,86,68,308,4,100
2018-06-05 21:15:00,84,92,88,84,348,4,100
2018-06-05 21:20:00,69,76,81,58,284,4,100
2018-06-05 21:25:00,50,66,70,68,254,4,100
2018-06-05 21:30:00,94,86,83,59,322,4,100
2018-06-05 21:35:00,96,86,71,69,322,4,100
2018-06-05 21:40:00,74,81,66,47,268,4,100
2018-06-05 21:45:00,73,88,69,65,295,4,100
2018-06-05 21:50:00,62,73,78,56,269,4,100
2018-06-05 21:55:00,78,81,70,44,273,4,100
2018-06-05 22:00:00,55,77,72,43,247,4,100
2018-06-05 22:05:00,59,77,74,57,267,4,100
2018-06-05 22:10:00,68,73,67,48,256,4,100
2018-06-05 22:15:00,62,87,75,46,270,4,100
2018-06-05 22:20:00,64,71,69,59,263,4,100
2018-06-05 22:25:00,59,81,64,46,250,4,100
2018-06-05 22:30:00,56,67,47,50,220,4,100
2018-06-05 22:35:00,38,67,56,53,214,4,100
2018-06-05 22:40:00,56,68,72,43,239,4,100
2018-06-05 22:45:00,64,63,66,48,241,4,100
2018-06-05 22:50:00,55,66,51,43,215,4,100
2018-06-05 22:55:00,32,59,56,44,191,4,100
2018-06-05 23:00:00,48,61,55,34,198,4,100
2018-06-05 23:05:00,32,46,47,33,158,4,100
2018-06-05 23:10:00,34,53,43,31,161,4,100
2018-06-05 23:15:00,39,50,45,37,171,4,100
2018-06-05 23:20:00,44,48,41,34,167,4,100
2018-06-05 23:25:00,36,58,42,36,172,4,100
2018-06-05 23:30:00,36,45,43,30,154,4,100
2018-06-05 23:35:00,31,40,43,39,153,4,100
2018-06-05 23:40:00,35,31,40,31,137,4,100
2018-06-05 23:45:00,37,41,41,28,147,4,100
2018-06-05 23:50:00,31,33,30,30,124,4,100
2018-06-05 23:55:00,28,38,36,30,132,4,100
2018-06-06 00:00:00,32,39,26,21,118,4,100
2018-06-06 00:05:00,21,36,33,26,116,4,100
2018-06-06 00:10:00,26,44,32,27,129,4,100
2018-06-06 00:15:00,29,32,31,20,112,4,100
2018-06-06 00:20:00,18,24,26,27,95,4,100
2018-06-06 00:25:00,20,24,41,25,110,4,100
2018-06-06 00:30:00,14,33,29,28,104,4,100
2018-06-06 00:35:00,16,33,29,16,94,4,100
2018-06-06 00:40:00,11,26,21,21,79,4,100
2018-06-06 00:45:00,18,25,19,25,87,4,100
2018-06-06 00:50:00,19,29,27,21,96,4,100
2018-06-06 00:55:00,12,18,22,26,78,4,100
2018-06-06 01:00:00,13,14,15,15,57,4,100
2018-06-06 01:05:00,9,21,27,26,83,4,100
2018-06-06 01:10:00,13,19,28,25,85,4,100
2018-06-06 01:15:00,14,21,25,24,84,4,100
2018-06-06 01:20:00,13,23,16,24,76,4,100
2018-06-06 01:25:00,12,18,14,22,66,4,100
2018-06-06 01:30:00,11,15,23,21,70,4,100
2018-06-06 01:35:00,7,22,17,21,67,4,100
2018-06-06 01:40:00,10,17,23,13,63,4,100
2018-06-06 01:45:00,9,19,21,24,73,4,100
2018-06-06 01:50:00,8,16,19,14,57,4,100
2018-06-06 01:55:00,9,20,16,20,65,4,100
2018-06-06 02:00:00,2,14,20,19,55,4,100
2018-06-06 02:05:00,7,14,19,16,56,4,100
2018-06-06 02:10:00,8,19,20,14,61,4,100
2018-06-06 02:15:00,13,21,22,27,83,4,100
2018-06-06 02:20:00,8,11,13,15,47,4,100
2018-06-06 02:25:00,9,13,20,19,61,4,100
2018-06-06 02:30:00,5,14,17,22,58,4,100
2018-06-06 02:35:00,7,17,20,26,70,4,100
2018-06-06 02:40:00,12,17,20,18,67,4,100
2018-06-06 02:45:00,7,15,20,29,71,4,100
2018-06-06 02:50:00,6,21,21,21,69,4,100
2018-06-06 02:55:00,6,14,19,21,60,4,100
2018-06-06 03:00:00,7,13,18,17,55,4,100
2018-06-06 03:05:00,4,12,14,18,48,4,100
2018-06-06 03:10:00,5,16,18,19,58,4,100
2018-06-06 03:15:00,6,18,25,19,68,4,100
2018-06-06 03:20:00,9,20,18,22,69,4,100
2018-06-06 03:25:00,10,17,18,26,71,4,100
2018-06-06 03:30:00,9,25,30,26,90,4,100
2018-06-06 03:35:00,13,30,32,26,101,4,100
2018-06-06 03:40:00,19,38,35,35,127,4,100
2018-06-06 03:45:00,20,45,41,34,140,4,100
2018-06-06 03:50:00,16,34,33,39,122,4,100
2018-06-06 03:55:00,12,35,29,25,101,4,100
2018-06-06 04:00:00,8,25,23,31,87,4,100
2018-06-06 04:05:00,15,23,23,23,84,4,100
2018-06-06 04:10:00,12,21,30,25,88,4,100
2018-06-06 04:15:00,16,32,34,27,109,4,100
2018-06-06 04:20:00,12,30,36,27,105,4,100
2018-06-06 04:25:00,20,34,40,35,129,4,100
2018-06-06 04:30:00,20,32,36,32,120,4,100
2018-06-06 04:35:00,13,37,48,40,138,4,100
2018-06-06 04:40:00,42,49,62,39,192,4,100
2018-06-06 04:45:00,45,58,58,43,204,4,100
2018-06-06 04:50:00,57,75,50,49,231,4,100
2018-06-06 04:55:00,23,42,45,36,146,4,100
2018-06-06 05:00:00,30,52,45,46,173,4,100
2018-06-06 05:05:00,23,43,43,30,139,4,100
2018-06-06 05:10:00,42,46,39,40,167,4,100
2018-06-06 05:15:00,47,59,48,45,199,4,100
2018-06-06 05:20:00,60,66,65,53,244,4,100
2018-06-06 05:25:00,49,60,61,53,223,4,100
2018-06-06 05:30:00,47,60,59,53,219,4,100
2018-06-06 05:35:00,54,81,82,70,287,4,100
2018-06-06 05:40:00,73,92,99,70,334,4,100
2018-06-06 05:45:00,81,87,94,87,349,4,100
2018-06-06 05:50:00,101,105,82,67,355,4,100
2018-06-06 05:55:00,74,76,92,76,318,4,100
2018-06-06 06:00:00,42,58,72,62,234,4,100
2018-06-06 06:05:00,73,95,73,62,303,4,100
2018-06-06 06:10:00,61,81,54,60,256,4,100
2018-06-06 06:15:00,76,93,72,68,309,4,100
2018-06-06 06:20:00,68,93,92,76,329,4,100
2018-06-06 06:25:00,84,88,83,83,338,4,100
2018-06-06 06:30:00,92,101,79,90,362,4,100
2018-06-06 06:35:00,100,109,109,94,412,4,100
2018-06-06 06:40:00,112,103,111,102,428,4,100
2018-06-06 06:45:00,138,134,120,120,512,4,100
2018-06-06 06:50:00,130,120,120,109,479,4,100
2018-06-06 06:55:00,127,120,112,110,469,4,100
2018-06-06 07:00:00,121,123,112,107,463,4,100
2018-06-06 07:05:00,111,113,107,114,445,4,100
2018-06-06 07:10:00,117,119,108,114,458,4,100
2018-06-06 07:15:00,120,109,96,109,434,4,100
2018-06-06 07:20:00,119,126,124,100,469,4,100
2018-06-06 07:25:00,140,132,120,120,512,4,100
2018-06-06 07:30:00,127,131,112,101,471,4,100
2018-06-06 07:35:00,170,127,121,118,536,4,100
2018-06-06 07:40:00,156,130,133,127,546,4,100
2018-06-06 07:45:00,162,140,134,134,570,4,100
2018-06-06 07:50:00,140,125,105,118,488,4,100
2018-06-06 07:55:00,133,122,111,116,482,4,100
2018-06-06 08:00:00,130,123,99,113,465,4,100
2018-06-06 08:05:00,122,118,113,107,460,4,100
2018-06-06 08:10:00,102,111,99,95,407,4,100
2018-06-06 08:15:00,132,131,124,120,507,4,100
2018-06-06 08:20:00,130,124,112,97,463,4,100
2018-06-06 08:25:00,108,118,107,93,426,4,100
2018-06-06 08:30:00,104,105,98,81,388,4,100
2018-06-06 08:35:00,78,109,110,93,390,4,100
2018-06-06 08:40:00,106,101,119,85,411,4,100
2018-06-06 08:45:00,155,130,129,122,536,4,100
2018-06-06 08:50:00,122,113,120,100,455,4,100
2018-06-06 08:55:00,101,105,115,100,421,4,100
2018-06-06 09:00:00,99,116,100,84,399,4,100
2018-06-06 09:05:00,95,102,96,93,386,4,100
2018-06-06 09:10:00,84,107,91,70,352,4,100
2018-06-06 09:15:00,91,113,95,108,407,4,100
2018-06-06 09:20:00,97,109,110,96,412,4,100
2018-06-06 09:25:00,84,101,98,104,387,4,100
2018-06-06 09:30:00,85,98,92,101,376,4,100
2018-06-06 09:35:00,104,101,113,96,414,4,100
2018-06-06 09:40:00,99,112,124,105,440,4,100
2018-06-06 09:45:00,102,108,118,98,426,4,100
2018-06-06 09:50:00,100,110,111,113,434,4,100
2018-06-06 09:55:00,99,101,108,105,413,4,100
2018-06-06 10:00:00,94,100,112,103,409,4,100
2018-06-06 10:05:00,86,103,111,118,418,4,100
2018-06-06 10:10:00,79,109,115,101,404,4,100
2018-06-06 10:15:00,91,106,96,94,387,4,100
2018-06-06 10:20:00,101,102,123,102,428,4,100
2018-06-06 10:25:00,74,113,90,108,385,4,100
2018-06-06 10:30:00,76,113,97,89,375,4,100
2018-06-06 10:35:00,111,115,113,93,432,4,100
2018-06-06 10:40:00,90,117,115,101,423,4,100
2018-06-06 10:45:00,115,109,109,104,437,4,100
2018-06-06 10:50:00,104,115,99,89,407,4,100
2018-06-06 10:55:00,112,118,108,94,432,4,100
2018-06-06 11:00:00,95,122,119,104,440,4,100
2018-06-06 11:05:00,97,101,112,92,402,4,100
2018-06-06 11:10:00,99,109,115,93,416,4,100
2018-06-06 11:15:00,101,130,107,94,432,4,100
2018-06-06 11:20:00,102,120,111,82,415,4,100
2018-06-06 11:25:00,114,116,102,84,416,4,100
2018-06-06 11:30:00,108,113,91,96,408,4,100
2018-06-06 11:35:00,115,104,109,99,427,4,100
2018-06-06 11:40:00,109,116,95,84,404,4,100
2018-06-06 11:45:00,118,137,109,94,458,4,100
2018-06-06 11:50:00,114,115,112,90,431,4,100
2018-06-06 11:55:00,131,130,102,102,465,4,100
2018-06-06 12:00:00,112,118,118,111,459,4,100
2018-06-06 12:05:00,138,121,115,105,479,4,100
2018-06-06 12:10:00,128,139,109,99,475,4,100
2018-06-06 12:15:00,133,135,118,97,483,4,100
2018-06-06 12:20:00,124,117,112,95,448,4,100
2018-06-06 12:25:00,134,117,125,113,489,4,100
2018-06-06 12:30:00,150,145,122,107,524,4,100
2018-06-06 12:35:00,122,131,115,96,464,4,100
2018-06-06 12:40:00,139,132,117,102,490,4,100
2018-06-06 12:45:00,148,137,115,102,502,4,100
2018-06-06 12:50:00,132,133,104,114,483,4,100
2018-06-06 12:55:00,146,123,123,105,497,4,100
2018-06-06 13:00:00,128,120,123,113,484,4,100
2018-06-06 13:05:00,131,124,113,104,472,4,100
2018-06-06 13:10:00,128,128,108,128,492,4,100
2018-06-06 13:15:00,145,135,121,112,513,4,100
2018-06-06 13:20:00,163,144,132,110,549,4,100
2018-06-06 13:25:00,132,126,125,104,487,4,100
2018-06-06 13:30:00,156,146,129,109,540,4,100
2018-06-06 13:35:00,157,147,130,112,546,4,100
2018-06-06 13:40:00,126,137,128,114,505,4,100
2018-06-06 13:45:00,138,133,132,99,502,4,100
2018-06-06 13:50:00,137,144,125,100,506,4,100
2018-06-06 13:55:00,153,137,128,103,521,4,100
2018-06-06 14:00:00,122,125,108,106,461,4,100
2018-06-06 14:05:00,155,130,119,112,516,4,100
2018-06-06 14:10:00,160,150,136,115,561,4,100
2018-06-06 14:15:00,158,134,126,113,531,4,100
2018-06-06 14:20:00,155,138,134,111,538,4,100
2018-06-06 14:25:00,149,142,133,117,541,4,100
2018-06-06 14:30:00,159,145,136,121,561,4,100
2018-06-06 14:35:00,171,153,109,108,541,4,100
2018-06-06 14:40:00,180,155,130,115,580,4,100
2018-06-06 14:45:00,160,146,126,121,553,4,100
2018-06-06 14:50:00,155,129,128,96,508,4,100
2018-06-06 14:55:00,178,137,125,107,547,4,100
2018-06-06 15:00:00,163,136,128,109,536,4,100
2018-06-06 15:05:00,161,143,108,101,513,4,100
2018-06-06 15:10:00,165,155,127,106,553,4,100
2018-06-06 15:15:00,162,152,120,106,540,4,100
2018-06-06 15:20:00,166,152,140,111,569,4,100
2018-06-06 15:25:00,139,142,126,108,515,4,100
2018-06-06 15:30:00,144,132,132,117,525,4,100
2018-06-06 15:35:00,154,145,144,126,569,4,100
2018-06-06 15:40:00,131,138,123,108,500,4,100
2018-06-06 15:45:00,153,146,149,119,567,4,100
2018-06-06 15:50:00,160,136,132,108,536,4,100
2018-06-06 15:55:00,164,144,122,121,551,4,100
2018-06-06 16:00:00,160,146,130,107,543,4,100
2018-06-06 16:05:00,168,157,130,95,550,4,100
2018-06-06 16:10:00,158,147,138,118,561,4,100
2018-06-06 16:15:00,144,135,133,107,519,4,100
2018-06-06 16:20:00,147,132,130,109,518,4,100
2018-06-06 16:25:00,156,138,120,87,501,4,100
2018-06-06 16:30:00,154,142,149,116,561,4,100
2018-06-06 16:35:00,162,144,135,112,553,4,100
2018-06-06 16:40:00,137,130,141,113,521,4,100
2018-06-06 16:45:00,133,134,154,110,531,4,100
2018-06-06 16:50:00,150,143,136,106,535,4,100
2018-06-06 16:55:00,140,130,139,126,535,4,100
2018-06-06 17:00:00,130,126,137,111,504,4,100
2018-06-06 17:05:00,148,144,147,120,559,4,100
2018-06-06 17:10:00,126,120,122,92,460,4,100
2018-06-06 17:15:00,131,135,135,117,518,4,100
2018-06-06 17:20:00,134,123,130,92,479,4,100
2018-06-06 17:25:00,139,126,139,113,517,4,100
2018-06-06 17:30:00,129,119,119,80,447,4,100
2018-06-06 17:35:00,142,138,141,114,535,4,100
2018-06-06 17:40:00,136,135,144,120,535,4,100
2018-06-06 17:45:00,136,130,139,118,523,4,100
2018-06-06 17:50:00,139,122,124,113,498,4,100
2018-06-06 17:55:00,136,127,134,119,516,4,100
2018-06-06 18:00:00,157,143,149,119,568,4,100
2018-06-06 18:05:00,131,126,124,120,501,4,100
2018-06-06 18:10:00,140,135,124,106,505,4,100
2018-06-06 18:15:00,140,148,148,129,565,4,100
2018-06-06 18:20:00,120,126,131,128,505,4,100
2018-06-06 18:25:00,139,134,142,122,537,4,100
2018-06-06 18:30:00,145,141,131,107,524,4,100
2018-06-06 18:35:00,152,141,128,103,524,4,100
2018-06-06 18:40:00,149,132,131,109,521,4,100
2018-06-06 18:45:00,149,147,106,107,509,4,100
2018-06-06 18:50:00,147,132,105,98,482,4,100
2018-06-06 18:55:00,111,107,108,80,406,4,100
2018-06-06 19:00:00,118,109,118,76,421,4,100
2018-06-06 19:05:00,110,103,96,78,387,4,100
2018-06-06 19:10:00,91,99,83,73,346,4,100
2018-06-06 19:15:00,116,110,106,72,404,4,100
2018-06-06 19:20:00,129,121,107,81,438,4,100
2018-06-06 19:25:00,107,106,107,68,388,4,100
2018-06-06 19:30:00,116,118,98,81,413,4,100
2018-06-06 19:35:00,99,97,104,71,371,4,100
2018-06-06 19:40:00,82,94,93,70,339,4,100
2018-06-06 19:45:00,88,104,85,73,350,4,100
2018-06-06 19:50:00,102,101,99,81,383,4,100
2018-06-06 19:55:00,85,96,92,81,354,4,100
2018-06-06 20:00:00,80,91,93,73,337,4,100
2018-06-06 20:05:00,104,98,79,62,343,4,100
2018-06-06 20:10:00,91,91,89,73,344,4,100
2018-06-06 20:15:00,94,92,80,65,331,4,100
2018-06-06 20:20:00,104,95,99,85,383,4,100
2018-06-06 20:25:00,92,91,86,58,327,4,100
2018-06-06 20:30:00,91,91,89,70,341,4,100
2018-06-06 20:35:00,73,84,83,75,315,4,100
2018-06-06 20:40:00,89,77,71,58,295,4,100
2018-06-06 20:45:00,111,115,92,74,392,4,100
2018-06-06 20:50:00,92,98,78,82,350,4,100
2018-06-06 20:55:00,89,91,80,74,334,4,100
2018-06-06 21:00:00,90,89,81,69,329,4,100
2018-06-06 21:05:00,81,87,91,68,327,4,100
2018-06-06 21:10:00,72,87,84,85,328,4,100
2018-06-06 21:15:00,89,105,95,77,366,4,100
2018-06-06 21:20:00,76,92,86,74,328,4,100
2018-06-06 21:25:00,83,91,80,76,330,4,100
2018-06-06 21:30:00,67,83,77,71,298,4,100
2018-06-06 21:35:00,87,78,74,56,295,4,100
2018-06-06 21:40:00,78,81,83,65,307,4,100
2018-06-06 21:45:00,74,72,62,60,268,4,100
2018-06-06 21:50:00,60,73,59,53,245,4,100
2018-06-06 21:55:00,88,75,73,51,287,4,100
2018-06-06 22:00:00,71,73,73,54,271,4,100
2018-06-06 22:05:00,63,67,58,56,244,4,100
2018-06-06 22:10:00,66,75,64,47,252,4,100
2018-06-06 22:15:00,73,64,60,44,241,4,100
2018-06-06 22:20:00,67,73,65,48,253,4,100
2018-06-06 22:25:00,60,72,63,43,238,4,100
2018-06-06 22:30:00,61,74,76,55,266,4,100
2018-06-06 22:35:00,58,60,66,52,236,4,100
2018-06-06 22:40:00,52,66,60,41,219,4,100
2018-06-06 22:45:00,70,74,64,46,254,4,100
2018-06-06 22:50:00,54,60,56,43,213,4,100
2018-06-06 22:55:00,35,54,46,36,171,4,100
2018-06-06 23:00:00,37,46,51,37,171,4,100
2018-06-06 23:05:00,33,54,44,34,165,4,100
2018-06-06 23:10:00,42,54,31,36,163,4,100
2018-06-06 23:15:00,39,43,40,34,156,4,100
2018-06-06 23:20:00,38,46,44,38,166,4,100
2018-06-06 23:25:00,34,47,46,30,157,4,100
2018-06-06 23:30:00,34,48,46,38,166,4,100
2018-06-06 23:35:00,37,50,40,40,167,4,100
2018-06-06 23:40:00,39,42,44,29,154,4,100
2018-06-06 23:45:00,17,30,33,36,116,4,100
2018-06-06 23:50:00,29,35,39,37,140,4,100
2018-06-06 23:55:00,33,48,39,35,155,4,100
2018-06-07 00:00:00,20,35,31,29,115,4,100
2018-06-07 00:05:00,24,29,37,20,110,4,100
2018-06-07 00:10:00,24,33,32,23,112,4,100
2018-06-07 00:15:00,18,24,30,25,97,4,100
2018-06-07 00:20:00,25,33,31,26,115,4,100
2018-06-07 00:25:00,16,29,32,27,104,4,100
2018-06-07 00:30:00,17,27,31,27,102,4,100
2018-06-07 00:35:00,14,21,19,21,75,4,100
2018-06-07 00:40:00,18,26,28,26,98,4,100
2018-06-07 00:45:00,19,22,25,15,81,4,100
2018-06-07 00:50:00,14,24,31,29,98,4,100
2018-06-07 00:55:00,21,26,23,21,91,4,100
2018-06-07 01:00:00,9,18,29,21,77,4,100
2018-06-07 01:05:00,14,22,22,17,75,4,100
2018-06-07 01:10:00,14,24,19,19,76,4,100
2018-06-07 01:15:00,18,21,13,22,74,4,100
2018-06-07 01:20:00,13,24,25,19,81,4,100
2018-06-07 01:25:00,10,19,19,16,64,4,100
2018-06-07 01:30:00,10,14,14,20,58,4,100
2018-06-07 01:35:00,8,12,20,32,72,4,100
2018-06-07 01:40:00,13,23,22,15,73,4,100
2018-06-07 01:45:00,5,26,19,21,71,4,100
2018-06-07 01:50:00,10,20,25,20,75,4,100
2018-06-07 01:55:00,9,24,19,18,70,4,100
2018-06-07 02:00:00,2,16,19,26,63,4,100
2018-06-07 02:05:00,7,15,24,22,68,4,100
2018-06-07 02:10:00,5,15,14,24,58,4,100
2018-06-07 02:15:00,9,19,23,21,72,4,100
2018-06-07 02:20:00,6,16,14,18,54,4,100
2018-06-07 02:25:00,3,9,14,22,48,4,100
2018-06-07 02:30:00,9,11,23,21,64,4,100
2018-06-07 02:35:00,3,22,14,17,56,4,100
2018-06-07 02:40:00,8,16,16,20,60,4,100
2018-06-07 02:45:00,7,17,16,28,68,4,100
2018-06-07 02:50:00,18,10,20,21,69,4,100
2018-06-07 02:55:00,7,19,16,18,60,4,100
2018-06-07 03:00:00,14,14,19,28,75,4,100
2018-06-07 03:05:00,4,12,16,11,43,4,100
2018-06-07 03:10:00,6,25,21,22,74,4,100
2018-06-07 03:15:00,10,20,30,16,76,4,100
2018-06-07 03:20:00,9,13,24,23,69,4,100
2018-06-07 03:25:00,6,16,19,21,62,4,100
2018-06-07 03:30:00,13,25,27,30,95,4,100
2018-06-07 03:35:00,14,23,27,33,97,4,100
2018-06-07 03:40:00,23,37,42,29,131,4,100
2018-06-07 03:45:00,24,33,36,32,125,4,100
2018-06-07 03:50:00,17,39,40,33,129,4,100
2018-06-07 03:55:00,14,22,26,27,89,4,100
2018-06-07 04:00:00,10,22,35,32,99,4,100
2018-06-07 04:05:00,8,24,27,19,78,4,100
2018-06-07 04:10:00,13,32,33,25,103,4,100
2018-06-07 04:15:00,18,24,36,27,105,4,100
2018-06-07 04:20:00,19,29,34,29,111,4,100
2018-06-07 04:25:00,19,35,38,28,120,4,100
2018-06-07 04:30:00,24,40,34,31,129,4,100
2018-06-07 04:35:00,22,38,40,42,142,4,100
2018-06-07 04:40:00,41,49,49,62,201,4,100
2018-06-07 04:45:00,47,63,56,53,219,4,100
2018-06-07 04:50:00,43,55,53,43,194,4,100
2018-06-07 04:55:00,28,54,47,43,172,4,100
2018-06-07 05:00:00,26,35,40,34,135,4,100
2018-06-07 05:05:00,20,42,40,37,139,4,100
2018-06-07 05:10:00,39,50,42,38,169,4,100
2018-06-07 05:15:00,47,55,51,46,199,4,100
2018-06-07 05:20:00,48,68,55,47,218,4,100
2018-06-07 05:25:00,52,56,63,54,225,4,100
2018-06-07 05:30:00,46,59,63,66,234,4,100
2018-06-07 05:35:00,59,79,75,63,276,4,100
2018-06-07 05:40:00,83,90,82,84,339,4,100
2018-06-07 05:45:00,90,97,77,83,347,4,100
2018-06-07 05:50:00,101,104,94,78,377,4,100
2018-06-07 05:55:00,73,88,73,78,312,4,100
2018-06-07 06:00:00,69,74,72,64,279,4,100
2018-06-07 06:05:00,63,82,57,63,265,4,100
2018-06-07 06:10:00,70,73,70,64,277,4,100
2018-06-07 06:15:00,76,95,82,70,323,4,100
2018-06-07 06:20:00,89,85,84,67,325,4,100
2018-06-07 06:25:00,77,92,75,82,326,4,100
2018-06-07 06:30:00,59,97,74,81,311,4,100
2018-06-07 06:35:00,89,119,100,103,411,4,100
2018-06-07 06:40:00,118,117,112,100,447,4,100
2018-06-07 06:45:00,139,131,115,111,496,4,100
2018-06-07 06:50:00,151,138,118,138,545,4,100
2018-06-07 06:55:00,121,103,113,102,439,4,100
2018-06-07 07:00:00,113,123,101,109,446,4,100
2018-06-07 07:05:00,120,102,106,112,440,4,100
2018-06-07 07:10:00,113,111,119,119,462,4,100
2018-06-07 07:15:00,143,129,123,126,521,4,100
2018-06-07 07:20:00,124,130,130,126,510,4,100
2018-06-07 07:25:00,108,107,121,111,447,4,100
2018-06-07 07:30:00,120,129,106,99,454,4,100
2018-06-07 07:35:00,143,117,104,93,457,4,100
2018-06-07 07:40:00,175,141,121,120,557,4,100
2018-06-07 07:45:00,171,141,127,131,570,4,100
2018-06-07 07:50:00,167,159,118,131,575,4,100
2018-06-07 07:55:00,122,122,104,101,449,4,100
2018-06-07 08:00:00,128,127,118,110,483,4,100
2018-06-07 08:05:00,124,121,110,113,468,4,100
2018-06-07 08:10:00,125,122,110,90,447,4,100
2018-06-07 08:15:00,141,126,99,104,470,4,100
2018-06-07 08:20:00,100,119,95,105,419,4,100
2018-06-07 08:25:00,119,120,107,99,445,4,100
2018-06-07 08:30:00,107,113,94,87,401,4,100
2018-06-07 08:35:00,93,103,98,99,393,4,100
2018-06-07 08:40:00,114,121,104,110,449,4,100
2018-06-07 08:45:00,129,124,128,107,488,4,100
2018-06-07 08:50:00,134,121,106,97,458,4,100
2018-06-07 08:55:00,113,127,110,100,450,4,100
2018-06-07 09:00:00,106,129,95,87,417,4,100
2018-06-07 09:05:00,85,110,99,97,391,4,100
2018-06-07 09:10:00,75,100,106,97,378,4,100
2018-06-07 09:15:00,105,109,104,94,412,4,100
2018-06-07 09:20:00,94,99,107,107,407,4,100
2018-06-07 09:25:00,98,108,107,97,410,4,100
2018-06-07 09:30:00,88,105,90,71,354,4,100
2018-06-07 09:35:00,99,107,100,98,404,4,100
2018-06-07 09:40:00,94,108,101,97,400,4,100
2018-06-07 09:45:00,110,121,127,107,465,4,100
2018-06-07 09:50:00,109,115,105,97,426,4,100
2018-06-07 09:55:00,101,116,103,94,414,4,100
2018-06-07 10:00:00,107,108,116,107,438,4,100
2018-06-07 10:05:00,92,108,106,93,399,4,100
2018-06-07 10:10:00,86,112,102,85,385,4,100
2018-06-07 10:15:00,113,119,118,117,467,4,100
2018-06-07 10:20:00,111,113,100,99,423,4,100
2018-06-07 10:25:00,135,129,117,97,478,4,100
2018-06-07 10:30:00,101,110,109,88,408,4,100
2018-06-07 10:35:00,118,115,106,97,436,4,100
2018-06-07 10:40:00,86,121,111,85,403,4,100
2018-06-07 10:45:00,93,107,94,93,387,4,100
2018-06-07 10:50:00,96,111,110,104,421,4,100
2018-06-07 10:55:00,95,114,108,81,398,4,100
2018-06-07 11:00:00,103,121,104,88,416,4,100
2018-06-07 11:05:00,103,110,108,99,420,4,100
2018-06-07 11:10:00,116,125,118,103,462,4,100
2018-06-07 11:15:00,106,125,111,96,438,4,100
2018-06-07 11:20:00,112,117,106,97,432,4,100
2018-06-07 11:25:00,109,118,94,103,424,4,100
2018-06-07 11:30:00,133,129,106,93,461,4,100
2018-06-07 11:35:00,124,135,120,103,482,4,100
2018-06-07 11:40:00,116,123,119,96,454,4,100
2018-06-07 11:45:00,114,137,113,107,471,4,100
2018-06-07 11:50:00,101,116,110,93,420,4,100
2018-06-07 11:55:00,111,115,116,98,440,4,100
2018-06-07 12:00:00,111,110,113,104,438,4,100
2018-06-07 12:05:00,120,112,121,117,470,4,100
2018-06-07 12:10:00,125,127,127,99,478,4,100
2018-06-07 12:15:00,123,134,112,102,471,4,100
2018-06-07 12:20:00,139,143,127,107,516,4,100
2018-06-07 12:25:00,125,131,120,94,470,4,100
2018-06-07 12:30:00,112,124,122,96,454,4,100
2018-06-07 12:35:00,118,120,112,96,446,4,100
2018-06-07 12:40:00,135,124,111,122,492,4,100
2018-06-07 12:45:00,150,140,126,106,522,4,100
2018-06-07 12:50:00,144,133,109,106,492,4,100
2018-06-07 12:55:00,127,131,119,99,476,4,100
2018-06-07 13:00:00,121,120,113,105,459,4,100
2018-06-07 13:05:00,132,131,120,99,482,4,100
2018-06-07 13:10:00,129,134,113,109,485,4,100
2018-06-07 13:15:00,135,123,138,100,496,4,100
2018-06-07 13:20:00,146,127,108,102,483,4,100
2018-06-07 13:25:00,150,144,128,106,528,4,100
2018-06-07 13:30:00,137,147,125,112,521,4,100
2018-06-07 13:35:00,139,137,115,103,494,4,100
2018-06-07 13:40:00,128,131,117,109,485,4,100
2018-06-07 13:45:00,158,145,121,110,534,4,100
2018-06-07 13:50:00,167,143,139,116,565,4,100
2018-06-07 13:55:00,162,127,107,105,501,4,100
2018-06-07 14:00:00,130,141,110,101,482,4,100
2018-06-07 14:05:00,139,141,106,83,469,4,100
2018-06-07 14:10:00,151,151,152,106,560,4,100
2018-06-07 14:15:00,134,129,121,108,492,4,100
2018-06-07 14:20:00,140,145,111,94,490,4,100
2018-06-07 14:25:00,145,136,111,115,507,4,100
2018-06-07 14:30:00,159,140,126,113,538,4,100
2018-06-07 14:35:00,169,160,131,122,582,4,100
2018-06-07 14:40:00,162,150,126,109,547,4,100
2018-06-07 14:45:00,169,143,138,108,558,4,100
2018-06-07 14:50:00,174,146,137,109,566,4,100
2018-06-07 14:55:00,164,144,147,107,562,4,100
2018-06-07 15:00:00,152,145,117,103,517,4,100
2018-06-07 15:05:00,161,131,132,105,529,4,100
2018-06-07 15:10:00,182,159,143,94,578,4,100
2018-06-07 15:15:00,153,147,142,116,558,4,100
2018-06-07 15:20:00,159,157,125,108,549,4,100
2018-06-07 15:25:00,174,146,125,108,553,4,100
2018-06-07 15:30:00,153,149,140,106,548,4,100
2018-06-07 15:35:00,169,155,147,118,589,4,100
2018-06-07 15:40:00,152,137,121,107,517,4,100
2018-06-07 15:45:00,159,143,142,123,567,4,100
2018-06-07 15:50:00,154,142,128,114,538,4,100
2018-06-07 15:55:00,159,138,127,118,542,4,100
2018-06-07 16:00:00,169,147,132,106,554,4,100
2018-06-07 16:05:00,154,139,121,109,523,4,100
2018-06-07 16:10:00,132,117,129,104,482,4,100
2018-06-07 16:15:00,138,135,130,113,516,4,100
2018-06-07 16:20:00,152,144,137,121,554,4,100
2018-06-07 16:25:00,133,133,128,104,498,4,100
2018-06-07 16:30:00,144,135,130,120,529,4,100
2018-06-07 16:35:00,145,139,143,123,550,4,100
2018-06-07 16:40:00,138,140,155,121,554,4,100
2018-06-07 16:45:00,130,128,133,123,514,4,100
2018-06-07 16:50:00,139,134,124,96,493,4,100
2018-06-07 16:55:00,131,127,136,112,506,4,100
2018-06-07 17:00:00,136,130,134,111,511,4,100
2018-06-07 17:05:00,126,127,116,98,467,4,100
2018-06-07 17:10:00,142,138,138,110,528,4,100
2018-06-07 17:15:00,128,123,139,107,497,4,100
2018-06-07 17:20:00,139,135,137,113,524,4,100
2018-06-07 17:25:00,151,144,138,110,543,4,100
2018-06-07 17:30:00,144,144,129,99,516,4,100
2018-06-07 17:35:00,110,113,111,94,428,4,100
2018-06-07 17:40:00,133,134,134,124,525,4,100
2018-06-07 17:45:00,135,137,148,121,541,4,100
2018-06-07 17:50:00,139,147,148,123,557,4,100
2018-06-07 17:55:00,157,142,130,115,544,4,100
2018-06-07 18:00:00,140,143,146,117,546,4,100
2018-06-07 18:05:00,138,141,134,130,543,4,100
2018-06-07 18:10:00,144,130,131,103,508,4,100
2018-06-07 18:15:00,144,150,135,101,530,4,100
2018-06-07 18:20:00,134,134,130,112,510,4,100
2018-06-07 18:25:00,134,138,154,112,538,4,100
2018-06-07 18:30:00,153,150,129,107,539,4,100
2018-06-07 18:35:00,161,149,117,98,525,4,100
2018-06-07 18:40:00,161,138,126,113,538,4,100
2018-06-07 18:45:00,123,128,110,82,443,4,100
2018-06-07 18:50:00,131,131,121,101,484,4,100
2018-06-07 18:55:00,138,127,114,73,452,4,100
2018-06-07 19:00:00,115,111,114,83,423,4,100
2018-06-07 19:05:00,124,137,102,89,452,4,100
2018-06-07 19:10:00,124,125,110,98,457,4,100
2018-06-07 19:15:00,115,103,94,75,387,4,100
2018-06-07 19:20:00,102,109,76,74,361,4,100
2018-06-07 19:25:00,97,99,93,80,369,4,100
2018-06-07 19:30:00,99,108,98,80,385,4,100
2018-06-07 19:35:00,86,97,76,62,321,4,100
2018-06-07 19:40:00,100,107,86,75,368,4,100
2018-06-07 19:45:00,98,92,102,80,372,4,100
2018-06-07 19:50:00,88,93,81,57,319,4,100
2018-06-07 19:55:00,89,91,84,59,323,4,100
2018-06-07 20:00:00,90,94,83,67,334,4,100
2018-06-07 20:05:00,86,97,94,77,354,4,100
2018-06-07 20:10:00,80,89,85,58,312,4,100
2018-06-07 20:15:00,103,92,90,81,366,4,100
2018-06-07 20:20:00,115,95,92,79,381,4,100
2018-06-07 20:25:00,100,98,92,70,360,4,100
2018-06-07 20:30:00,94,100,89,69,352,4,100
2018-06-07 20:35:00,82,90,74,71,317,4,100
2018-06-07 20:40:00,98,108,91,70,367,4,100
2018-06-07 20:45:00,113,106,100,66,385,4,100
2018-06-07 20:50:00,100,88,92,77,357,4,100
2018-06-07 20:55:00,115,103,104,65,387,4,100
2018-06-07 21:00:00,87,95,86,77,345,4,100
2018-06-07 21:05:00,98,99,100,78,375,4,100
2018-06-07 21:10:00,96,91,98,74,359,4,100
2018-06-07 21:15:00,114,108,88,75,385,4,100
2018-06-07 21:20:00,112,102,101,75,390,4,100
2018-06-07 21:25:00,96,104,90,81,371,4,100
2018-06-07 21:30:00,98,95,82,69,344,4,100
2018-06-07 21:35:00,122,107,89,71,389,4,100
2018-06-07 21:40:00,109,101,94,67,371,4,100
2018-06-07 21:45:00,83,91,78,58,310,4,100
2018-06-07 21:50:00,95,98,76,66,335,4,100
2018-06-07 21:55:00,90,98,74,65,327,4,100
2018-06-07 22:00:00,80,90,76,63,309,4,100
2018-06-07 22:05:00,78,91,73,58,300,4,100
2018-06-07 22:10:00,84,90,62,57,293,4,100
2018-06-07 22:15:00,85,96,75,51,307,4,100
2018-06-07 22:20:00,92,98,73,60,323,4,100
2018-06-07 22:25:00,72,81,71,50,274,4,100
2018-06-07 22:30:00,62,70,81,45,258,4,100
2018-06-07 22:35:00,75,69,72,50,266,4,100
2018-06-07 22:40:00,69,63,74,55,261,4,100
2018-06-07 22:45:00,73,70,71,46,260,4,100
2018-06-07 22:50:00,63,80,66,58,267,4,100
2018-06-07 22:55:00,53,61,58,45,217,4,100
2018-06-07 23:00:00,61,59,60,39,219,4,100
2018-06-07 23:05:00,61,62,48,55,226,4,100
2018-06-07 23:10:00,49,48,54,41,192,4,100
2018-06-07 23:15:00,48,65,63,45,221,4,100
2018-06-07 23:20:00,46,57,48,41,192,4,100
2018-06-07 23:25:00,27,41,41,37,146,4,100
2018-06-07 23:30:00,35,55,57,41,188,4,100
2018-06-07 23:35:00,47,54,48,34,183,4,100
2018-06-07 23:40:00,29,53,40,41,163,4,100
2018-06-07 23:45:00,36,41,43,32,152,4,100
2018-06-07 23:50:00,29,39,40,37,145,4,100
2018-06-07 23:55:00,29,43,32,32,136,4,100
2018-06-08 00:00:00,20,40,31,23,114,4,100
2018-06-08 00:05:00,23,35,22,25,105,4,100
2018-06-08 00:10:00,12,30,24,25,91,4,100
2018-06-08 00:15:00,34,48,54,40,176,4,100
2018-06-08 00:20:00,27,39,44,31,141,4,100
2018-06-08 00:25:00,20,28,35,28,111,4,100
2018-06-08 00:30:00,16,32,26,34,108,4,100
2018-06-08 00:35:00,19,32,36,24,111,4,100
2018-06-08 00:40:00,22,37,34,29,122,4,100
2018-06-08 00:45:00,28,37,40,31,136,4,100
2018-06-08 00:50:00,17,28,24,20,89,4,100
2018-06-08 00:55:00,18,27,33,27,105,4,100
2018-06-08 01:00:00,11,28,27,18,84,4,100
2018-06-08 01:05:00,15,22,29,23,89,4,100
2018-06-08 01:10:00,5,24,22,28,79,4,100
2018-06-08 01:15:00,28,33,20,21,102,4,100
2018-06-08 01:20:00,19,28,31,29,107,4,100
2018-06-08 01:25:00,9,18,24,25,76,4,100
2018-06-08 01:30:00,12,24,20,29,85,4,100
2018-06-08 01:35:00,11,20,23,17,71,4,100
2018-06-08 01:40:00,15,17,23,23,78,4,100
2018-06-08 01:45:00,14,17,23,22,76,4,100
2018-06-08 01:50:00,19,22,21,22,84,4,100
2018-06-08 01:55:00,13,14,16,14,57,4,100
2018-06-08 02:00:00,13,22,27,23,85,4,100
2018-06-08 02:05:00,6,19,19,27,71,4,100
2018-06-08 02:10:00,14,17,27,25,83,4,100
2018-06-08 02:15:00,17,14,14,16,61,4,100
2018-06-08 02:20:00,7,16,16,22,61,4,100
2018-06-08 02:25:00,8,15,20,22,65,4,100
2018-06-08 02:30:00,9,16,22,20,67,4,100
2018-06-08 02:35:00,14,24,27,18,83,4,100
2018-06-08 02:40:00,8,17,22,23,70,4,100
2018-06-08 02:45:00,10,16,10,17,53,4,100
2018-06-08 02:50:00,17,20,18,17,72,4,100
2018-06-08 02:55:00,7,17,27,20,71,4,100
2018-06-08 03:00:00,4,14,18,16,52,4,100
2018-06-08 03:05:00,6,17,21,15,59,4,100
2018-06-08 03:10:00,8,17,19,13,57,4,100
2018-06-08 03:15:00,6,17,15,19,57,4,100
2018-06-08 03:20:00,14,18,24,22,78,4,100
2018-06-08 03:25:00,14,20,19,22,75,4,100
2018-06-08 03:30:00,7,21,25,32,85,4,100
2018-06-08 03:35:00,18,35,28,28,109,4,100
2018-06-08 03:40:00,21,31,31,23,106,4,100
2018-06-08 03:45:00,18,39,30,32,119,4,100
2018-06-08 03:50:00,28,35,43,25,131,4,100
2018-06-08 03:55:00,23,31,26,32,112,4,100
2018-06-08 04:00:00,6,23,27,25,81,4,100
2018-06-08 04:05:00,11,28,26,22,87,4,100
2018-06-08 04:10:00,15,29,31,31,106,4,100
2018-06-08 04:15:00,19,30,30,25,104,4,100
2018-06-08 04:20:00,9,31,37,36,113,4,100
2018-06-08 04:25:00,15,19,30,23,87,4,100
2018-06-08 04:30:00,26,42,53,45,166,4,100
2018-06-08 04:35:00,29,44,40,39,152,4,100
2018-06-08 04:40:00,42,48,58,37,185,4,100
2018-06-08 04:45:00,41,53,60,46,200,4,100
2018-06-08 04:50:00,48,46,58,51,203,4,100
2018-06-08 04:55:00,28,43,42,37,150,4,100
2018-06-08 05:00:00,16,55,48,35,154,4,100
2018-06-08 05:05:00,25,34,35,37,131,4,100
2018-06-08 05:10:00,27,49,42,44,162,4,100
2018-06-08 05:15:00,42,70,52,45,209,4,100
2018-06-08 05:20:00,52,79,52,45,228,4,100
2018-06-08 05:25:00,42,61,59,45,207,4,100
2018-06-08 05:30:00,53,64,65,66,248,4,100
2018-06-08 05:35:00,59,73,68,61,261,4,100
2018-06-08 05:40:00,81,98,83,72,334,4,100
2018-06-08 05:45:00,103,108,94,84,389,4,100
2018-06-08 05:50:00,87,95,94,83,359,4,100
2018-06-08 05:55:00,78,109,79,64,330,4,100
2018-06-08 06:00:00,66,87,71,66,290,4,100
2018-06-08 06:05:00,57,80,75,58,270,4,100
2018-06-08 06:10:00,70,73,67,64,274,4,100
2018-06-08 06:15:00,73,86,75,65,299,4,100
2018-06-08 06:20:00,79,88,78,82,327,4,100
2018-06-08 06:25:00,82,83,85,80,330,4,100
2018-06-08 06:30:00,93,94,87,73,347,4,100
2018-06-08 06:35:00,91,110,96,80,377,4,100
2018-06-08 06:40:00,118,121,119,90,448,4,100
2018-06-08 06:45:00,130,127,113,104,474,4,100
2018-06-08 06:50:00,132,124,118,113,487,4,100
2018-06-08 06:55:00,116,119,93,94,422,4,100
2018-06-08 07:00:00,106,100,106,105,417,4,100
2018-06-08 07:05:00,83,97,92,107,379,4,100
2018-06-08 07:10:00,95,101,96,116,408,4,100
2018-06-08 07:15:00,115,120,112,124,471,4,100
2018-06-08 07:20:00,121,129,131,121,502,4,100
2018-06-08 07:25:00,113,119,99,115,446,4,100
2018-06-08 07:30:00,130,113,111,96,450,4,100
2018-06-08 07:35:00,134,130,108,111,483,4,100
2018-06-08 07:40:00,165,155,131,137,588,4,100
2018-06-08 07:45:00,151,131,126,113,521,4,100
2018-06-08 07:50:00,144,127,115,112,498,4,100
2018-06-08 07:55:00,147,139,122,115,523,4,100
2018-06-08 08:00:00,101,111,110,90,412,4,100
2018-06-08 08:05:00,100,100,99,89,388,4,100
2018-06-08 08:10:00,90,108,88,87,373,4,100
2018-06-08 08:15:00,122,116,107,99,444,4,100
2018-06-08 08:20:00,103,112,101,100,416,4,100
2018-06-08 08:25:00,115,124,109,86,434,4,100
2018-06-08 08:30:00,122,121,112,100,455,4,100
2018-06-08 08:35:00,96,110,110,83,399,4,100
2018-06-08 08:40:00,109,121,107,99,436,4,100
2018-06-08 08:45:00,107,122,103,98,430,4,100
2018-06-08 08:50:00,126,125,106,91,448,4,100
2018-06-08 08:55:00,114,127,114,106,461,4,100
2018-06-08 09:00:00,104,105,99,84,392,4,100
2018-06-08 09:05:00,75,97,98,84,354,4,100
2018-06-08 09:10:00,74,87,108,81,350,4,100
2018-06-08 09:15:00,103,115,111,95,424,4,100
2018-06-08 09:20:00,100,107,119,99,425,4,100
2018-06-08 09:25:00,109,114,108,103,434,4,100
2018-06-08 09:30:00,103,120,111,86,420,4,100
2018-06-08 09:35:00,104,110,117,97,428,4,100
2018-06-08 09:40:00,97,119,115,77,408,4,100
2018-06-08 09:45:00,112,124,132,102,470,4,100
2018-06-08 09:50:00,123,128,119,103,473,4,100
2018-06-08 09:55:00,102,105,93,93,393,4,100
2018-06-08 10:00:00,98,126,105,101,430,4,100
2018-06-08 10:05:00,125,126,119,97,467,4,100
2018-06-08 10:10:00,106,108,114,108,436,4,100
2018-06-08 10:15:00,108,111,126,106,451,4,100
2018-06-08 10:20:00,115,125,108,106,454,4,100
2018-06-08 10:25:00,110,127,110,104,451,4,100
2018-06-08 10:30:00,101,115,95,82,393,4,100
2018-06-08 10:35:00,120,128,121,108,477,4,100
2018-06-08 10:40:00,110,120,119,97,446,4,100
2018-06-08 10:45:00,112,122,110,89,433,4,100
2018-06-08 10:50:00,110,136,122,106,474,4,100
2018-06-08 10:55:00,124,119,115,106,464,4,100
2018-06-08 11:00:00,120,126,107,97,450,4,100
2018-06-08 11:05:00,114,134,117,114,479,4,100
2018-06-08 11:10:00,136,133,116,118,503,4,100
2018-06-08 11:15:00,131,127,119,98,475,4,100
2018-06-08 11:20:00,142,134,133,97,506,4,100
2018-06-08 11:25:00,134,128,117,99,478,4,100
2018-06-08 11:30:00,115,135,104,95,449,4,100
2018-06-08 11:35:00,129,132,119,99,479,4,100
2018-06-08 11:40:00,121,130,125,91,467,4,100
2018-06-08 11:45:00,136,119,118,101,474,4,100
2018-06-08 11:50:00,153,150,117,115,535,4,100
2018-06-08 11:55:00,162,146,132,106,546,4,100
2018-06-08 12:00:00,142,131,119,121,513,4,100
2018-06-08 12:05:00,157,147,144,105,553,4,100
2018-06-08 12:10:00,135,121,130,102,488,4,100
2018-06-08 12:15:00,136,138,122,111,507,4,100
2018-06-08 12:20:00,160,141,124,114,539,4,100
2018-06-08 12:25:00,146,133,119,114,512,4,100
2018-06-08 12:30:00,168,154,127,112,561,4,100
2018-06-08 12:35:00,150,146,137,101,534,4,100
2018-06-08 12:40:00,159,148,139,110,556,4,100
2018-06-08 12:45:00,164,146,119,118,547,4,100
2018-06-08 12:50:00,167,141,120,113,541,4,100
2018-06-08 12:55:00,166,145,120,110,541,4,100
2018-06-08 13:00:00,157,151,127,114,549,4,100
2018-06-08 13:05:00,171,156,144,121,592,4,100
2018-06-08 13:10:00,153,141,141,138,573,4,100
2018-06-08 13:15:00,180,151,126,108,565,4,100
2018-06-08 13:20:00,162,148,141,116,567,4,100
2018-06-08 13:25:00,144,141,136,111,532,4,100
2018-06-08 13:30:00,156,137,123,125,541,4,100
2018-06-08 13:35:00,155,134,118,112,519,4,100
2018-06-08 13:40:00,160,147,116,100,523,4,100
2018-06-08 13:45:00,169,151,133,120,573,4,100
2018-06-08 13:50:00,164,144,138,121,567,4,100
2018-06-08 13:55:00,146,137,112,112,507,4,100
2018-06-08 14:00:00,163,132,133,105,533,4,100
2018-06-08 14:05:00,164,154,133,105,556,4,100
2018-06-08 14:10:00,170,155,130,103,558,4,100
2018-06-08 14:15:00,140,133,130,107,510,4,100
2018-06-08 14:20:00,137,130,123,115,505,4,100
2018-06-08 14:25:00,149,140,129,115,533,4,100
2018-06-08 14:30:00,159,145,136,130,570,4,100
2018-06-08 14:35:00,162,138,125,110,535,4,100
2018-06-08 14:40:00,133,143,132,117,525,4,100
2018-06-08 14:45:00,131,130,119,98,478,4,100
2018-06-08 14:50:00,139,131,137,110,517,4,100
2018-06-08 14:55:00,133,131,126,102,492,4,100
2018-06-08 15:00:00,143,135,136,123,537,4,100
2018-06-08 15:05:00,168,145,140,110,563,4,100
2018-06-08 15:10:00,136,129,133,125,523,4,100
2018-06-08 15:15:00,138,134,126,111,509,4,100
2018-06-08 15:20:00,138,130,129,112,509,4,100
2018-06-08 15:25:00,134,134,130,117,515,4,100
2018-06-08 15:30:00,143,130,135,111,519,4,100
2018-06-08 15:35:00,160,140,145,121,566,4,100
2018-06-08 15:40:00,140,128,119,102,489,4,100
2018-06-08 15:45:00,149,135,131,106,521,4,100
2018-06-08 15:50:00,121,119,135,102,477,4,100
2018-06-08 15:55:00,147,143,127,115,532,4,100
2018-06-08 16:00:00,129,122,136,110,497,4,100
2018-06-08 16:05:00,124,126,134,100,484,4,100
2018-06-08 16:10:00,138,139,123,106,506,4,100
2018-06-08 16:15:00,121,128,131,113,493,4,100
2018-06-08 16:20:00,137,131,145,112,525,4,100
2018-06-08 16:25:00,140,143,136,117,536,4,100
2018-06-08 16:30:00,128,128,122,103,481,4,100
2018-06-08 16:35:00,125,122,127,107,481,4,100
2018-06-08 16:40:00,130,128,140,120,518,4,100
2018-06-08 16:45:00,146,142,126,112,526,4,100
2018-06-08 16:50:00,125,133,101,95,454,4,100
2018-06-08 16:55:00,133,137,119,108,497,4,100
2018-06-08 17:00:00,126,131,133,114,504,4,100
2018-06-08 17:05:00,118,130,139,102,489,4,100
2018-06-08 17:10:00,121,139,126,119,505,4,100
2018-06-08 17:15:00,128,126,123,99,476,4,100
2018-06-08 17:20:00,127,108,106,98,439,4,100
2018-06-08 17:25:00,123,118,136,112,489,4,100
2018-06-08 17:30:00,137,138,128,117,520,4,100
2018-06-08 17:35:00,119,123,123,104,469,4,100
2018-06-08 17:40:00,138,128,116,98,480,4,100
2018-06-08 17:45:00,129,126,126,116,497,4,100
2018-06-08 17:50:00,122,114,108,107,451,4,100
2018-06-08 17:55:00,145,134,156,128,563,4,100
2018-06-08 18:00:00,130,123,128,109,490,4,100
2018-06-08 18:05:00,134,132,132,115,513,4,100
2018-06-08 18:10:00,129,117,128,106,480,4,100
2018-06-08 18:15:00,121,121,138,109,489,4,100
2018-06-08 18:20:00,118,110,118,107,453,4,100
2018-06-08 18:25:00,116,126,136,124,502,4,100
2018-06-08 18:30:00,127,136,142,109,514,4,100
2018-06-08 18:35:00,130,127,135,101,493,4,100
2018-06-08 18:40:00,130,127,141,117,515,4,100
2018-06-08 18:45:00,126,131,118,90,465,4,100
2018-06-08 18:50:00,138,142,133,105,518,4,100
2018-06-08 18:55:00,126,117,123,89,455,4,100
2018-06-08 19:00:00,90,85,96,90,361,4,100
2018-06-08 19:05:00,119,113,119,103,454,4,100
2018-06-08 19:10:00,134,118,109,101,462,4,100
2018-06-08 19:15:00,152,128,136,94,510,4,100
2018-06-08 19:20:00,154,149,121,95,519,4,100
2018-06-08 19:25:00,164,139,126,108,537,4,100
2018-06-08 19:30:00,136,136,130,101,503,4,100
2018-06-08 19:35:00,122,122,111,84,439,4,100
2018-06-08 19:40:00,104,121,112,81,418,4,100
2018-06-08 19:45:00,125,116,94,84,419,4,100
2018-06-08 19:50:00,137,123,105,74,439,4,100
2018-06-08 19:55:00,108,108,102,83,401,4,100
2018-06-08 20:00:00,124,130,111,77,442,4,100
2018-06-08 20:05:00,135,109,100,81,425,4,100
2018-06-08 20:10:00,103,111,93,67,374,4,100
2018-06-08 20:15:00,129,128,106,91,454,4,100
2018-06-08 20:20:00,118,109,94,89,410,4,100
2018-06-08 20:25:00,108,104,95,75,382,4,100
2018-06-08 20:30:00,117,103,101,76,397,4,100
2018-06-08 20:35:00,128,120,93,72,413,4,100
2018-06-08 20:40:00,108,110,92,83,393,4,100
2018-06-08 20:45:00,115,100,93,69,377,4,100
2018-06-08 20:50:00,130,117,106,86,439,4,100
2018-06-08 20:55:00,115,105,111,85,416,4,100
2018-06-08 21:00:00,120,119,96,92,427,4,100
2018-06-08 21:05:00,131,135,109,91,466,4,100
2018-06-08 21:10:00,130,124,116,92,462,4,100
2018-06-08 21:15:00,131,114,108,75,428,4,100
2018-06-08 21:20:00,113,94,93,80,380,4,100
2018-06-08 21:25:00,122,116,107,82,427,4,100
2018-06-08 21:30:00,141,134,124,80,479,4,100
2018-06-08 21:35:00,131,117,110,67,425,4,100
2018-06-08 21:40:00,86,99,93,69,347,4,100
2018-06-08 21:45:00,126,94,104,76,400,4,100
2018-06-08 21:50:00,112,105,92,78,387,4,100
2018-06-08 21:55:00,85,85,87,58,315,4,100
2018-06-08 22:00:00,105,112,85,62,364,4,100
2018-06-08 22:05:00,96,104,97,69,366,4,100
2018-06-08 22:10:00,96,99,87,64,346,4,100
2018-06-08 22:15:00,97,102,79,79,357,4,100
2018-06-08 22:20:00,89,95,97,70,351,4,100
2018-06-08 22:25:00,91,89,79,58,317,4,100
2018-06-08 22:30:00,84,98,76,57,315,4,100
2018-06-08 22:35:00,78,95,75,59,307,4,100
2018-06-08 22:40:00,91,89,80,57,317,4,100
2018-06-08 22:45:00,78,75,81,55,289,4,100
2018-06-08 22:50:00,71,76,72,63,282,4,100
2018-06-08 22:55:00,53,70,61,45,229,4,100
2018-06-08 23:00:00,69,82,69,60,280,4,100
2018-06-08 23:05:00,76,75,57,55,263,4,100
2018-06-08 23:10:00,70,77,67,57,271,4,100
2018-06-08 23:15:00,60,67,60,53,240,4,100
2018-06-08 23:20:00,62,67,68,47,244,4,100
2018-06-08 23:25:00,70,68,60,37,235,4,100
2018-06-08 23:30:00,41,58,57,50,206,4,100
2018-06-08 23:35:00,38,47,60,34,179,4,100
2018-06-08 23:40:00,34,51,53,47,185,4,100
2018-06-08 23:45:00,69,60,57,48,234,4,100
2018-06-08 23:50:00,82,79,63,45,269,4,100
2018-06-08 23:55:00,44,63,50,43,200,4,100
